##################################################
#             =       *    ==   =            * **#
#**** ***  ======    *   *========= == =**  * * *#
#         =  ===== *== = ====*==*==== === **   ==#
# **     =* *=   ===  === =  *==  ==* =*== == ===#
#    =* ==*     *===*   =  *   *  **     ==*== = #
#  =====   *       =*   * *     **   *  * = ==** #
#*= = ==   *     **    *    *  *** *   *     =   #
#==*=        *    *  ****     *    *    **   *   #
#=*   * *  *            * *  *   **  ***       * #
# * * *   *     **              ***  *     * * * #
#   * *   ***       *  *         **          *   #
#                *    *   **      ***  *  *      #
#  * *** *   ****   *  *     * * *  **    **     #
#*  ** *      *        *         **  **    * *  *#
#      *             * *       **           ***  #
#     **  *  *  *    *              **       * * #
# *       *   * *   * *   **   *        *  *  ** #
#  *    *   *         * *      *  *       *   *  #
##################################################
